42 24
+----------------------------------------+
|****************************************|
|*        +----------+                  *|
|*        |          |                  *|
|*        |          |                  *|
|*        |     0    |++++++++++++++++++*|
|*        |          |++++++++++++++++++*|
|*        |          |                  *|
|*        |*         |                  *|
|*        +----------+                  *|
|*                                      *|
|*                                      *|
|*                                      *|
|*                                      *|
|*                                      *|
|*                                      *|
|*                              0       *|
|*                                      *|
|*                                      *|
|*                                      *|
|*                                      *|
|*                                      *|
|****************************************|
+----------------------------------------+
12
10 10
9 10
8 10
8 9
8 8
8 7
8 6
8 5
8 4
8 3
9 3
19 3

